#####
#S  #
# # #
#   #
# # #
#  #E#
#####
