###########
#S#  #    #
# # # ## # 
#   #     E
###########
