###########
#S#  #    #
# # # ## #
#   #     
###########
