#######
# S   #
#   # #
# #   #
# # # #
#   # #
###E###
