######
#S   #
# ## #
#  E #
######


