#######
# S#  #
# ### #
#   # #
# # # #
#   # #
###E###