#######
#S   ##
##  #E#
#     #
#######
